NO ./pictures/NO.xpm
SO ./pictures/SO.xpm
WE ./pictures/WE.xpm
EA ./pictures/EA.xpm

F 47,79,10
C 255,255,0



1111111111111111111111111111111111111111
111111111111111
100000000000001
100000000000001
1000000000000011111111111
1000000001100000000000001
1000000000000011111111111
100000000000011
1000000N0001001
100000000000001
100000000000001
100000000000001
100000010000001
100000000000001
111111111111111